CIkIlmayacaktI	CIk Il ma yacak tI
CIkarIna	CIkar I na, CIkar In a
CIkartIlIr	CIkar t Il Ir
CIkrIklarIn	CIkrIk lar In
CIrpIp	CIrp Ip
COreklerden	COrek ler den
COzebilirler	COz ebil ir ler
CaGIrdIklarInI	CaGIr dIk lar I nI, CaGIr dIk lar In I, CaGIr dIk larI nI
CabalIyorsun	Caba lIyor sun
CalISIlamamIS	Cal IS Il ama mIS, CalIS Il ama mIS
CalISmasIn	Cal IS ma sIn, CalIS ma sIn
CalayIm	Cal a yIm, Cala yIm
CantasIz	Canta sIz
CarpIlmanIz	Carp Il man Iz, Carp Il ma nIz
CatalcayI	Catalca yI
CeSnilerin	CeSni ler in
Cekilirdik	Cek il ir di k
Cekmemesi	Cek me me si
Cenede	Cened e, Cene de
Cevirmektir	Cevir mek tir
CiCeklerinden	CiCek ler in den, CiCek ler i nden, CiCek leri nden
Cindeydi	Cin de ydi
Cizgisine	Ciz gi si ne
CobanlIGa	Coban lIG a
CubuGa	CubuG a
IlImlIlIGInI	IlIm lI lIG I nI, IlIm lI lIG In I
IsItISIn	IsIt IS In
IzdIrabI	IzdIrab I
OGrenemeyeceGimi	OGren eme yeceG im i
OGretisi	OGreti si
OdediGinizi	Ode diG iniz i
Ofkelendiler	Ofke len di ler
OlCeGinde	OlCeG i nde, OlCeG in de
OldUrUyorlarsa	Ol dUr Uyor lar sa
OlmeyeceGine	Ol me yeceG in e, Ol me yeceG i ne
Onemsemeli	Onemse meli, Onemse me li
OngOrUlmekte	OngOr Ul mek te, OngOr Ul mekte
OpUSUyordu	Op US Uyor du
OrgUtlemesiyle	OrgUt le me si yle
OrtUlmUStUr	Or t Ul mUS tUr, Ort Ul mUS tUr
OvUnmektedir	Ov Un mekte dir, Ov Un mek te dir
Ozcanla	Ozcan la
Ozendirmek	Ozen dir mek, Oze n dir mek
OzgUvenli	OzgUven li
SIkI	SIk I
SaSIlIGInI	SaSI lIG In I, SaSI lIG I nI
SahIsI	SahIs I
Saklatarak	Sak lat arak
SarabI	Sarab I
Sebekesine	Sebeke si ne
SekillendirilmiStir	Sekil len dir il miS tir
Serifdeki	Serif de ki
SiSmanlatmaz	SiSman lat maz
Sirinyerdeki	Sirinyer de ki
Suurumuza	Suur umuz a
UleStirildiGi	U leS tir il diG i, UleS tir il diG i
Universitelerle	Universite ler le
Uretilmesini	Uret il me si ni, Ure t il me si ni
UskUfUnU	UskUf U nU, UskUf Un U
UtopyacIlIkla	Utopya cI lIk la
Uzerindekilerin	Uzer i nde ki ler in, Uzeri n de ki ler in, Uzer in de ki ler in
aCIklayIp	aCIk la yIp
aCabileceGine	aC abil eceG i ne, aC abil eceG in e
aGIrlIGImIz	aGIr lIG Im Iz, aGIr lIG ImIz
aGartmaya	aGar t ma ya
aGzImIzdan	aGz ImIz dan
aSaGIdaGdereliler	aSaGIdaGdere li ler
aSmIStI	aS mIS tI
abimi	abi m i
acelecilikten	acele ci lik ten
adamISlIGI	ada mIS lIG I
adetleriyle	adet ler i yle, adet leri yle
affetmedi	affet me di
ahlakdISIlIk	ahlakdISI lIk
akISIkIn	akISIk In
akadIn	akad In
aklamaktan	ak la mak tan
aksimizde	aks imiz de, aksi miz de
aktedilecek	akted il ecek
alISmadIGIm	alIS ma dIG Im, al IS ma dIG Im
alIndIGIndaysa	al In dIG In da ysa, al In dIG I nda ysa
alacaklIlIk	al acak lI lIk
alaylarInI	alay lar I nI, alay lar In I, alay larI nI
aldattIGInIzI	aldat tIG InIz I
algIlanabilme	algI lan abil me, al gI lan abil me
allahlarI	allah lar I, allah larI
altISar	altISar
amaClarImIz	amaC lar ImIz, amaC lar Im Iz
amerikasIz	amerika sIz
anImsatmadan	anImsa t ma dan, anImsa t madan
anamadIm	an ama dI m
animi	ani m i
anlaSmamIzI	an laS ma mIz I, anlaS ma mIz I
anlarInIn	an lar In In, an larI nIn, an lar I nIn
anlatmadInIz	an lat ma dI nIz, anla t ma dI nIz
anneanne	anneanne
antitezi	antitez i
arIndIrIyorlar	arIn dIr Iyor lar
araStIrmacIlarla	araStIr ma cI lar la
aralayacaktI	ara la yacak tI
arayISlarIndan	ara yIS lar I ndan, ara yIS lar In dan, ara yIS larI ndan
arkadaSlarImIn	arkadaS lar Im In
artIdayIz	artI da yIz
arttIramIyor	art tIr amIyor
asIrlardIr	asIr lar dIr, as Ir lar dIr
aslIndan	as lIn dan, asl I ndan, asl In dan
atIlImIm	atIl Im Im, at Il Im Im
atalarImIz	ata lar Im Iz, ata lar ImIz
ateSleri	ateS ler i, ateS leri
atlattIn	atla t tI n, atla t t In, at lat t In, at lat tI n
avSara	avSar a
avucunu	avuc un u, avuc u nu
ayIrabileceGimizi	ayIr abil eceG imiz i
ayamama	ay ama ma
aydInlatIlmasIndan	aydIn lat Il ma sI ndan
aynaya	ayna ya
ayrIlmamamIz	ayrIl ma ma mIz, ayrIl ma mam Iz, ayr Il ma ma mIz, ayr Il ma mam Iz
azalmamIStIr	azal ma mIS tIr
azma	az ma, azma
bIrakacaGImI	bIrak acaG Im I
bObreklerini	bObrek ler in i, bObrek leri ni, bObrek ler i ni
bOlgemizde	bOlge miz de
bUrUnebilirler	bUrU n ebil ir ler, bUr Un ebil ir ler
bUyUGUz	bUyUG Uz
bUyUtUcU	bUyU t UcU
baGImsIzlIGImIzI	baG Im sIz lIG ImIz I, baGIm sIz lIG ImIz I
baGlIdIrlar	baG lI dIr lar
baGlasInlar	baG la sInlar
baSarIsIzlIGIdIr	baSarI sIz lIG I dIr
baSkalaSIm	baSka laS Im
baSlamISIz	baS la mIS Iz, baSla mIS Iz
baSlayabilirler	baSla yabil ir ler, baS la yabil ir ler
baSvurulmamIStI	baSvur ul ma mIS tI
baf	baf
bahsetmediGimizi	bahset me diG imiz i
bakUdeki	bakU de ki
bakmalarInI	bak ma lar I nI, bak ma larI nI, bak ma lar In I
ballanIrsa	bal lan Ir sa
bantlarIyla	bant larI yla, bant lar I yla
bariton	bariton
basayI	basa yI
bastIrmIStIn	bas tIr mIS tI n
battIktan	bat tIk tan
bayramlarInIn	bayram lar In In, bayram lar I nIn, bayram larI nIn
beSimde	beS im de
bedbinliktir	bedbin lik tir
beklemezdik	bekle mez di k, bek le mez di k
belagatla	belagat la
belirlemedim	belirle me di m
belirtilmediGi	belir t il me diG i
benetlerinin	benet ler i nin, benet ler in in, benet leri nin
benzemezmiS	benze mez miS
bergama	bergama
besteciyle	beste ci yle
beygirlerini	beygir ler i ni, beygir ler in i, beygir leri ni
biCimiyle	biC im i yle, biCim i yle
bildiklerimiz	bildik ler im iz, bil dik ler imiz, bildik ler imiz, bil dik ler im iz
bileceGim	bil eceG im
bilgilerimi	bil gi ler im i
bilincinle	bilinc in le
bilmeyeceGiz	bil me yeceG iz
birCoGunun	birCoG u nun, birCoG un un
biriktirilmesinin	birik tir il me si nin
birleStirmesiyle	bir leS tir me si yle
bitirenlerin	bitir en ler in
bizimse	biz im se
boSalImIn	boSa l Im In, boSal Im In
bohCasInI	bohCa sI nI
borCluluk	borC lu luk
boylamaya	boy la ma ya, boyla ma ya
bozmasIydI	boz ma sI ydI
buGdaylarInI	buGday lar In I, buGday lar I nI, buGday larI nI
bulaStIGImI	bu laS tIG Im I, bulaS tIG Im I
bulayan	bula yan, bu la yan
buluSmuStuk	buluS muS tu k, bul uS muS tu k
bulunmalIsIn	bul un ma lI sIn
bunalabilir	buna l abil ir, bunal abil ir
buruSuklarI	buruSuk lar I, buruSuk larI
cIzIrtI	cIzIrtI
camcI	cam cI
canlandIrmIStIr	can lan dIr mIS tIr
ceketimin	ceket im in
ceolarInI	ceo larI nI, ceo lar In I, ceo lar I nI
cevaplandIrIlmasI	cevap lan dIr Il ma sI
charlesla	charles la
cinsiyetinden	cinsiyet in den, cinsiyet i nden
con	co n
dISlanIyorum	dIS lan Iyor um
dOkemiyor	dOk emiyor
dOnUStUrebildiler	dOn US tUr ebil di ler
dOnememen	dOn eme men
dOvUSemeyen	dOv US eme yen
dUSUnU	dUSUn U, dUSUnU, dUS U nU, dUS Un U
dUSUnecektir	dUSUn ecek tir, dUS Un ecek tir
dUSUrmedin	dUSUr me di n
dUSmanlara	dUSman lar a
dUnyamIzdaki	dUnya mIz da ki
dUzeltmelerine	dUzel t me ler in e, dUze l t me leri ne, dUzel t me ler i ne, dUzel t me leri ne, dUze l t me ler in e, dUze l t me ler i ne
dUzeyden	dUzey den
daGItamadIGIm	daGIt ama dIG Im
dalIm	dal Im, da lIm
damItIlmasI	damIt Il ma sI
danalardan	dana lar dan
davamI	dava m I
davranmamIStIr	davran ma mIS tIr
dayandIrIlmIS	daya n dIr Il mIS, dayan dIr Il mIS
deGerlendireceGinize	deGer len dir eceG iniz e
deGiSiklikte	deGiSik lik te
deGiStirilmesinin	deG iS tir il me si nin, deGiS tir il me si nin
deSildikCe	deS il dik Ce, deS il dikCe
defterimdeki	defter im de ki
deliliktir	deli lik tir
demirOzdUr	demirOz dUr
denendi	dene n di, de n en di
deneyselciliGin	deneysel ci liG in
densizlikle	densiz lik le
dergaha	dergah a
derneklerinin	dernek leri nin, dernek ler in in, dernek ler i nin
destekCilerini	destek Ci ler i ni, destek Ci ler in i, destek Ci leri ni
devamsIzlIklarIyla	devam sIz lIk lar I yla, devam sIz lIk larI yla
devrede	devre de, devred e
dezavantajlara	dezavantaj lar a
dikeyine	dikey i ne, dikey in e
dileke	dilek e
dinamiGini	dinamiG i ni, dinamiG in i
dinlenemedim	dinle n eme di m, din len eme di m, dinlen eme di m
diplere	dip ler e
diretmedi	dire t me di
diyalogdur	diyalog dur
dizgesinde	dizge si nde
doGmalar	doG ma lar
doGumuyla	doG um u yla
dokunabilirsen	dokun abil ir se n, doku n abil ir se n
dolaSmIS	do laS mIS, dolaS mIS
dolaysIzlIGIn	dolay sIz lIG In
donanIrken	dona n Ir ken
dostluklarla	dost luk lar la
dualarIma	dua lar Im a
duramIyoruz	dur amIyor uz
duruStaki	dur uS ta ki
duyamadIktan	duy ama dIk tan
duymasa	duy ma sa
duyurmamIStI	duyur ma mIS tI
eGitildikleri	eGit il dik ler i, eG it il dik ler i, eG it il dik leri, eG it il dik ler i, eGit il dik leri
eGmelidir	eG me li dir, eG meli dir
eSleStirilebilecek	eS leS tir il ebil ecek
edebildiGi	ed ebil diG i
edibe	edib e
edindiGini	ed in diG i ni, ed in diG in i, edin diG i ni, edin diG in i
efkarda	efkar da
ekibiyle	ekib i yle
ekmiS	ek miS
ektirir	ek tir ir
eleStirmeyeceksek	e leS tir me yecek se k, eleStir me yecek se k
elkatmIS	elkat mIS
emekliyi	emek li yi
emrin	emr in
enfrarujdaki	enfraruj da ki
enselenip	ense len ip
erdemindendir	erdem in den dir, erdem i nden dir
eriSebilsek	eriS ebil se k, er iS ebil se k
erkekleSen	erkek leS en
ertelenmeyecekmiS	ertele n me yecek miS, erte len me yecek miS
esirgememeliyiz	esirge me meli yiz, esirge me me li yiz
esrarlarIyla	esrar lar I yla, esrar larI yla
etkilemediklerine	et ki le me dik leri ne, et ki le me dik ler in e, etki le me dik ler i ne, etki l eme dik ler i ne, et ki le me dik ler i ne, etki l eme dik leri ne, etki l eme dik ler in e, etki le me dik leri ne, etki le me dik ler in e
etkitilecektir	etki t il ecek tir
etter	et t er
everdik	ever dik, ever di k
evliliklerinin	ev li lik ler i nin, ev li lik ler in in, ev li lik leri nin
eylemelerine	eyle me ler i ne, eyle me leri ne, ey le me ler in e, ey le me leri ne, ey le me ler i ne
ezilmiSlikte	ez il miS lik te
fIrlatmasI	fIr lat ma sI, fIrla t ma sI
fagot	fagot
fantezilere	fantezi ler e
farlarImI	far lar Im I
fazlalIGa	fazla lIG a
fenomeni	fenomen i
fethedilmemiS	fethed il me miS
fikirlerinde	fikir leri nde, fikir ler i nde, fikir ler in de
finans	finans
florasInda	flora sI nda
fosille	fosil le
fueloil	fueloil
gOCmenlerinden	gOCmen ler in den, gOCmen leri nden, gOCmen ler i nden
gOlgeliydi	gOlge li ydi
gOnderemiyor	gOnder emiyor
gOrUSUrken	gOr US Ur ken
gOrUlmekteydi	gOr Ul mek te ydi, gOr Ul mekte ydi
gOrUntUsU	gOrUntU sU
gOremiyormuSuz	gOr emiyor muS uz
gOrmelisiniz	gOr me li siniz
gOstergeleriydi	gOsterge leri ydi, gOsterge ler i ydi
gOstersem	gOster se m
gOzUkmek	gOzUk mek
gOzlemesini	gOz le me si ni, gOzleme si ni
gUCleStirmemek	gUC leS tir me mek
gUdUyor	gUd Uyor
gUldUrmenin	gUl dUr men in, gUl dUr me nin
gUnahsIzIn	gUnah sIz In
gUnlerimizi	gUn ler imiz i
gUvenenin	gUven en in
gUzelliGindeydi	gUzel liG in de ydi, gUzel liG i nde ydi
gaptan	gap tan
gayretin	gayret in
geCeceGinin	geC eceG i nin, geC eceG in in
geCindiGimi	geCin diG im i, geC in diG im i
geCirmeyecek	geCir me yecek
gebertmeliyiz	geber t me li yiz, geber t meli yiz
gelebilmesidir	gel ebil me si dir
geliSme	geliS me, gel iS me
gelinliGinin	gelin liG in in, gelin liG i nin
gemilere	gemi ler e
geniSletilemez	geniS let il emez
gerCekleStirdiklerimizle	gerCek leS tir dik ler imiz le
gerecekler	ger ecek ler
gerginliklere	gergin lik ler e
getireceGini	getir eceG i ni, getir eceG in i
getirmeyerek	getir me yerek
gezginidir	gezgin i dir
gidemediler	gid eme di ler
giovanninin	giovanni nin, giovanni n in
giriSiyorlar	giriS iyor lar, gir iS iyor lar
gitmediklerini	git me dik ler i ni, git me dik ler in i, git me dik leri ni
giyiliyor	giy il iyor
gizleyince	giz le yince
grozniyi	grozni yi
hIrCInlIk	hIrCIn lIk
hIzlandIrarak	hIz lan dIr arak
hUmanizmanIn	hUmanizma nIn, hUmanizma n In
haberdeyse	haber de yse
hafiflemek	hafif le mek
hakimiyetindeki	hakimiyet in de ki, hakimiyet i nde ki
halime	hal im e, halim e, hali m e
hamalInIm	hamal In Im
hangarlarI	hangar lar I, hangar larI
harbisi	harbi si
harflerinden	harf ler in den, harf leri nden, harf ler i nden
hasrettirmiS	hasret t ir miS, hasret tir miS
hatIrlamamIz	hatIr la ma mIz, hatIr la mam Iz
hatlarIyla	hat lar I yla, hat larI yla
hayIflandIGInI	hayIf lan dIG In I, hayIf lan dIG I nI
haykIrmakta	haykIr mak ta, haykIr makta
hazIrlanabilmesi	hazIr lan abil me si
hedefidir	hedef i dir
hemi	hem i, he m i
hesaplanacakmIS	hesap lan acak mIS
hezarfenin	hezarfen in
hinoGluhin	hinoGluhin
hissetmesini	hisset me si ni
hizmettir	hizmet tir
homojenleStirmesi	homojen leS tir me si
hububatI	hububat I
huzursuzluklarInI	huzur suz luk lar In I, huzur suz luk lar I nI, huzur suz luk larI nI
iCiSi	iC iS i
iCteki	iC te ki
iSbirlikCisidir	iSbirlikCi si dir, iSbirlik Ci si dir
iSlememesi	iS le me me si, iSle me me si
iSlevimizi	iSlev imiz i
ibiS	ibiS
idealini	ideal i ni, ideal in i
ihanetleri	ihanet ler i, ihanet leri
ihtiyarlarI	ihtiyar lar I, ihtiyar larI
iktibasta	iktibas ta
ilerideydi	ileri de ydi, ileride ydi
iletmez	ilet mez, i let mez
ilhanI	ilhan I
ilker	ilker
imarIna	imar I na, imar In a
imzala	imza la
inanIldIGI	inan Il dIG I
inanmayInIz	inan ma yInIz
incindirilerek	incin dir il erek
indirmiSler	in dir miS ler
inlerine	in ler i ne, in leri ne, in ler in e
intifadaya	intifada ya
irfanInkilerin	irfan In ki ler in
iskoCyanIn	iskoCya nIn, iskoCya n In
istatistikleridir	istatistik ler i dir, istatistik leri dir
istencinden	istenc in den, istenc i nden
istihbaratCIlIGInI	istihbarat CI lIG I nI, istihbarat CI lIG In I
italyalIlar	italya lI lar
itirazlarImIzda	itiraz lar ImIz da
iyisin	iyi sin
izlenimlerimizin	iz len im ler imiz in, izle n im ler imiz in
jalede	jale de
kISkIrtmalarIn	kISkIrt ma lar In, kISkIr t ma lar In
kIlgIn	kIl gIn, kIlgIn, kIlgI n
kIpIrtIlarIyla	kIpIrtI larI yla, kIpIrtI lar I yla
kIrbasIn	kIrba sIn, kIrb a sIn, kIrb asIn
kIsImsa	kIsIm sa, kIs Im sa
kIsmetinin	kIsmet i nin, kIsmet in in
kIyIlarInIza	kIyI lar InIz a
kIzIlordusu	kIzIlordu su
kOCek	kOCek
kOpUrsUn	kOpUr sUn
kOtUleStiren	kOtU leS tir en
kUCUltmeye	kUCUl t me ye
kUltUrUnUzle	kUltUr UnUz le
kUsUrlUk	kUsUr lUk
kaCInamayacaGI	kaC In ama yacaG I, kaCIn ama yacaG I
kaCamaktIr	kaCamak tIr
kaSmir	kaSmir
kabuldUr	kabul dUr
kadastrosunun	kadastro su nun
kafesli	kafes li
kahvemi	kahve m i
kalIrdInIz	kal Ir dI nIz
kaldIGIn	kal dIG In
kalemlinin	kalem li nin, kalem lin in
kalkanIm	kalk an Im, kalkan Im
kalpteki	kalp te ki
kamulaStIracaktIr	kamu laS tIr acak tIr
kanadoGlu	kanadoGlu
kangalIn	kangal In
kapIlarImIzI	kapI lar ImIz I
kapanmayI	kapa n ma yI
kaplIyordu	kap lIyor du
kaptanIndan	kap t an I ndan, kaptan I ndan, kap t an In dan, kaptan In dan
karIklarI	karIk larI, karIk lar I
karSIlaStIrIlIr	karSI laS tIr Il Ir
karSInIzdayIm	karSI nIz da yIm
karakterimin	karakter im in
kararla	karar la
kardeSimsin	kardeS im sin
karnIn	karn In
kasabaydI	kasaba ydI, kasab a ydI
katIlaSmIS	katI laS mIS
kataloGunun	kataloG u nun, kataloG un un
katlederler	katled er ler
kavgacI	kavga cI
kavrayamayacaktIm	kavra yama yacak tI m
kayIklardaki	kayIk lar da ki
kaybetmemesi	kaybet me me si
kaydedilmediGi	kayded il me diG i
kaynaklanabilir	kaynak lan abil ir
kazaka	kazak a
kazandIracaktIr	kazan dIr acak tIr
keSfedivermiS	keSfed iver miS
kelebektir	kelebek tir
kendilerindedir	kendi ler i nde dir, kendi ler in de dir, kendi leri nde dir
kerpiCleri	kerpiC ler i, kerpiC leri
kesimlerimize	kes im ler imiz e
kestirirdik	kes tir ir di k
kibarlar	kibar lar
kimliklerdir	kimlik ler dir, kim lik ler dir
kirlenme	kir len me
kitleme	kitle me, kitle m e, kit le me
koGulmuS	koG ul muS
koalisyonlarIyla	koalisyon larI yla, koalisyon lar I yla
koktum	kok tu m, kok t um
kollarIndayIz	kol lar I nda yIz, kol larI nda yIz, kol lar In da yIz
komedidir	komedi dir
konCertolar	konCerto lar
konmuStur	kon muS tur
konuSabilen	kon uS abil en, konuS abil en
konuSturalIm	kon uS tur a lIm, konuS tur a lIm
konumlanmasI	kon um lan ma sI, konum lan ma sI
koparmadI	kopar ma dI
korkakmISIm	korkak mIS Im
korolarIna	koro lar In a, koro lar I na, koro larI na
koruyacaGIz	koru yacaG Iz
kovuGundan	kovuG un dan, kovuG u ndan
koymazsanIz	koy maz sa nIz
kraliCeye	kraliCe ye
kuSUzUmUnU	kuSUzUmU n U
kubi	kubi
kulatIna	ku lat In a
kullanabilirsiniz	kul lan abil ir siniz, kullan abil ir siniz
kulvarlarInda	kulvar larI nda, kulvar lar In da, kulvar lar I nda
kurabileceGini	kur abil eceG i ni, kur abil eceG in i
kurdudur	kurd u dur
kurtarIlIr	kurtar Il Ir
kurtulmasI	kur t ul ma sI, kurtul ma sI
kuruluSlarImIzI	kur ul uS lar ImIz I, kuru l uS lar ImIz I, kurul uS lar ImIz I
kustuGunu	kus tuG un u, kus tuG u nu
kutuplar	kutup lar
lUksUmUzdU	lUks UmUz dU
lake	lake
lehimsiz	lehim siz
liberalleStirilmesi	liberal leS tir il me si
lisanlarInI	lisan lar In I, lisan larI nI, lisan lar I nI
lokmayla	lokma yla
mIzraklar	mIzrak lar
mUdUrlerin	mUdUr ler in
mUjdelediGi	mUjde le diG i
mUnasebetimizin	mUnasebet imiz in
mUsteSarI	mUsteSar I
mUziGim	mUziG im
mabet	mabet
mahallelisidir	mahalle li si dir
mahvolmak	mahvol mak
maksadImIzI	maksad ImIz I
mamasInda	mamas I nda, mamas In da, mama sI nda
mankenli	manken li
markada	marka da
maskesinin	maske si nin
mayalandIrIp	maya lan dIr Ip
meSrulaStIrIlmasInI	meSru laS tIr Il ma sI nI
medyam	medya m
mektuplarIndaki	mektup lar I nda ki, mektup larI nda ki, mektup lar In da ki
memurlukla	memur luk la
meraklanmIStIk	merak lan mIS tI k
mersinliyi	mersin li yi
meslektaSlarInIz	meslektaS lar In Iz, meslektaS lar InIz
mevcuda	mevcud a
meyvacI	meyva cI
mihraklarI	mihrak larI, mihrak lar I
milliler	mil li ler, milli ler
mirasIndIr	miras In dIr, mira sIn dIr
mizacImda	mizac Im da, miza cIm da
mondenler	monden ler, monde n ler
muGlaklaSacaGI	muGlak laS acaG I
muhafazakarlarla	muhafazakar lar la
muhtevasInda	muhteva sI nda
mutabakatIyla	mutabakat I yla
nOronlarIn	nOron lar In
naklediliyormuS	nakled il iyor muS
nasa	nas a, nasa
nedameti	nedamet i
nenizin	ne niz in
nevsal	nevsal
nilUfer	nilUfer
niyetleniyorum	niyet len iyor um
notasInda	nota sI nda
objeleStirme	obje leS tir me
ofislerin	ofis ler in
okumamIStI	oku ma mIS tI
okutulursa	ok ut ul ur sa, oku t ul ur sa
olacaGImda	ol acaG Im da
olda	ol da
olmamasIyla	ol ma ma sI yla
oluSturabilmiS	ol uS tur abil miS, oluS tur abil miS
olunabildiGini	ol un abil diG in i, ol un abil diG i ni
onarIlmak	onar Il mak
onurunuzu	onur unuz u
organizasyonlarI	organizasyon lar I, organizasyon larI
ortaklaSmacI	ortak laS ma cI
otelcilik	otel ci lik
oturakaldI	otur akal dI
otuzlardaki	otuz lar da ki
oynamasIdIr	oyna ma sI dIr
oyuncaklar	oyuncak lar
paCavralara	paCavra lar a
pamukCuklar	pamuk Cuk lar
parCalamIS	parCa la mIS
paralelliGini	paralel liG in i, paralel liG i ni
parlementosu	parlemento su
pasife	pasif e
patolojilerinde	patoloji ler i nde, patoloji ler in de, patoloji leri nde
paylaSmalarIndan	pay laS ma lar I ndan, pay laS ma larI ndan, pay laS ma lar In dan
pehlivanInI	pehlivan I nI, pehlivan In I
perCemlerinin	perCem ler in in, perCem ler i nin, perCem leri nin
petrolUyle	petrol U yle
pilota	pilot a
plakete	plaket e
pohpohlayacak	pohpoh la yacak
popUlistliktir	popUlist lik tir
pozisyondur	pozisyon dur
prodUksiyonlardI	prodUksiyon lar dI
propagandalarInI	propaganda lar I nI, propaganda lar In I, propaganda larI nI
puanlamaya	puan la ma ya
rUfekasI	rUfeka sI
rahatInIzI	rahat InIz I
rakkasen	rakkase n
rastlasam	rast la sa m
reddetmediklerini	reddet me dik ler i ni, reddet me dik ler in i, reddet me dik leri ni
rejide	reji de
reseptOrUnde	reseptOr U nde, reseptOr Un de
rezalettir	rezalet tir
rolUmU	rol Um U
ruhta	ruh ta
sIGInamaz	sIG In amaz, sIGIn amaz
sIkISmISlIGIn	sIk IS mIS lIG In
sIklaStIrdIm	sIk laS tIr dI m, sIk laS t Ir dI m
sInIrlandIrmadIlar	sInIr lan dIr ma dI lar
sIralanIrken	sIra lan Ir ken
sIyIrdIGImI	sIyIr dIG Im I
sOkmenden	sOk men den
sOylUyorsan	sOyl Uyor sa n
sOylenilmiS	sOyle n il miS
sOzcUklerdeki	sOz cUk ler de ki
sUngUnUz	sUngU n Uz, sUn gUn Uz, sUngU nUz, sUn gU nUz
sUrUlmekle	sUr Ul mek le, sUrU l mek le
sUrdUremezsiniz	sUrdUr eme zsiniz, sUr dUr eme zsiniz
sUrmeyeceksiniz	sUr me yecek siniz
sUzdUler	sUz dU ler
saGlIklIlIGIyla	saG lIk lI lIG I yla
saGlayabilirken	saGla yabil ir ken, saG la yabil ir ken
sabittir	sab it tir, sab it t ir, sabit tir
safmIS	saf mIS
sahneliyor	sahne liyor
sakinleStirdik	sakin leS tir dik, sakin leS tir di k, sakin leS t ir di k
salIverilmesini	salIver il me si ni
salgIlanmIS	sal gI lan mIS
samanlardI	saman lar dI
sanatsallaSmasInda	sanatsal laS ma sI nda
sansUrUnden	sansUr U nden, sansUr Un den
saptIGInIzda	sap tIG InIz da
sarImdIr	sar Im dIr, sarI m dIr, sarIm dIr
sarkmIStI	sark mIS tI
satIlmadIGInI	sat Il ma dIG In I, sat Il ma dIG I nI
savInIn	sav In In, sav I nIn
savsaklamamak	savsak la ma mak
sayIStaya	sayIStay a
saydamInIn	saydam In In, saydam I nIn
seCebiliriz	seC ebil ir iz
seCmelere	seC me ler e
seferberliGin	seferber liG in
selametCi	selamet Ci
semptomlarIna	semptom lar In a, semptom larI na, semptom lar I na
senteye	sente ye
sergiledim	ser gi le di m
serpiStirilen	serp iS tir il en
seslendiril	ses len dir il
sevdiysem	sev di yse m
sevilir	sev il ir
sevmediGinden	sev me diG in den, sev me diG i nden
seyrediyorduk	seyred iyor du k
shovda	shov da
sileceGi	sil eceG i
simgelerini	simge ler i ni, simge ler in i, simge leri ni
sininin	sin in in, sini n in, sini nin, sin i nin
sistemlerimiz	sistem ler im iz, sistem ler imiz
siyasileSmesi	siyasi leS me si
sofra	sofra
sokulmaya	sok ul ma ya
somkayanIn	somkaya n In, somkaya nIn
sonuClandIrIlmasInIn	sonuC lan dIr Il ma sI nIn
sorgulanacaktIk	sor gu lan acak tI k
sorulmasInIn	sor ul ma sI nIn, soru l ma sI nIn
southampton	southampton
soyutlamadan	soyut la ma dan, soyut la madan
standartlarIyla	standart lar I yla, standart larI yla
suClamalarIn	suC la ma lar In
sulak	sulak
sunmasIydI	sun ma sI ydI
suskunluGu	suskun luG u
tIkamamaya	tIk ama ma ya, tIka ma ma ya
tIrnaklanmIS	tIrnak lan mIS
tUkendim	tUken di m
tUndUkten	tUn dUk ten
tUrkerden	tUrker den
taSCIyan	taSCIyan
taSIyabilmelidir	taSI yabil meli dir, taSI yabil me li dir
tabaklarIn	tabak lar In
tacizcisine	taciz ci si ne
tahsillerine	tahsil ler i ne, tahsil ler in e, tahsil leri ne
takInmIStIr	tak In mIS tIr, takI n mIS tIr
taksitle	taksit le
taliplerin	talip ler in
tanISIyorlar	tan IS Iyor lar
tanImayacaGIna	tanI ma yacaG In a, tanI ma yacaG I na
tanItIlacak	tanI t Il acak, tan It Il acak
tanrICaydIn	tanrICa ydI n
tarafgirliGi	tarafgir liG i
tarihlendirilmiStir	tarih len dir il miS tir
tartIStIrIyor	tartIS tIr Iyor, tart IS tIr Iyor
tasarruflarIndaki	tasarruf lar In da ki, tasarruf lar I nda ki, tasarruf larI nda ki
tatminle	tatmin le
taylanddaki	tayland da ki
teSvik	teSvik
tedavisi	tedavi si
tekellerince	tekel ler in ce
teknolojideki	teknoloji de ki
teleonda	teleon da
temellendirecek	temel len dir ecek
temsillerden	temsil ler den
tepetaklak	tepetaklak
tereddUtlere	tereddUt ler e
terorizmi	terorizm i
tespittir	tespit tir
tezgaha	tezgah a
tiplemesinden	tip le me si nden
tokalaSmIS	toka laS mIS
toparlandIk	toparla n dI k, toparla n dIk, topar lan dIk, topar lan dI k, topar lan dIk, topar lan dI k
toplardamarlar	toplardamar lar
toptancIlarI	toptan cI lar I, toptan cI larI
trabzonsporda	trabzonspor da
troyayI	troya yI
turlarIm	tur lar Im
tutmalI	tut ma lI
tutukevi	tutukevi
tutunuyorsun	tut un uyor sun
uCuSur	uCuS ur, uC uS ur
uGradIk	uGra dI k, uGra dIk
uSaklIk	uSak lIk
ulaSabilirlerse	ulaS abil ir ler se, u laS abil ir ler se
ulema	ulema
umursamazlIk	umursa mazlIk
unutmayacaktIm	unut ma yacak tI m
uslanma	us lan ma
uyacaGImIzI	uy acaG ImIz I
uyarIsIz	uyarI sIz
uyguladIGI	uygula dIG I, uy gu la dIG I
uygunluGun	uygun luG un
uyuduGunuzu	uyu duG unuz u
uzadIGInda	uza dIG I nda, uza dIG In da
uzanabilecekleri	uza n abil ecek ler i, uza n abil ecek leri
uzlaStIrabilirsek	uz laS tIr abil ir se k, uzlaS tIr abil ir se k
vadisi	vadi si
valiyle	vali yle
vardiyada	vardiya da
varsalar	var sa lar
vatanperverlikten	vatanperver lik ten
veballer	vebal ler
verdiGimizden	ver diG imiz den
veriStirdi	ver iS tir di, ver iS t ir di
vermekmiS	ver mek miS
veziristanda	veziristan da
vitrinlerle	vitrin ler le
vurgulanmasInI	vur gu lan ma sI nI, vurgu lan ma sI nI
yIGInaGInIn	yIGInaG In In, yIGInaG I nIn
yIkmaktan	yIk mak tan
yIpranmadan	yIpra n madan, yIpra n ma dan
yOnelmiSliGin	yOnel miS liG in
yOnetiyormuS	yOnet iyor muS
yOrelerin	yOre ler in
yUkleniveren	yUk len iver en
yUkseltme	yUksel t me
yUrUtmeyen	yUrUt me yen, yUrU t me yen
yUzdeyim	yUz de yim, yUzde yim
yaGdIrdIklarI	yaG dIr dIk larI, yaG dIr dIk lar I
yaSamIyorsa	yaSa mIyor sa
yaSara	yaSar a
yaSlandIn	yaS lan dI n
yadsIyIcI	yadsI yIcI
yakInlIklarI	yakIn lIk lar I, yakIn lIk larI
yakalandIlar	yaka lan dI lar
yaklaSamIyorsa	yaklaS amIyor sa
yalamIS	yala mIS, ya la mIS
yamalarIn	yama lar In
yanItlIdIrlar	yanIt lI dIr lar
yani	yani
yansItabilmesi	yansI t abil me si
yapIlamadIGInI	yapI la ma dIG In I, yap Il ama dIG In I, yapI la ma dIG I nI, yap Il ama dIG I nI
yapItIndaki	yapIt In da ki, yapIt I nda ki
yapaylIGI	yapay lIG I
yaptIrIlabileceGinin	yap tIr Il abil eceG in in, yap tIr Il abil eceG i nin
yarIlar	yar I lar, yar Il ar, yarI lar
yaramazlIklar	yar amazlIk lar, yaramaz lIk lar, yara mazlIk lar
yaratIkmIS	yaratIk mIS
yarattInIz	yara t tI nIz, yarat tI nIz, yara t t InIz, yarat t InIz
yargIsInIn	yargI sI nIn, yar gI sI nIn
yasasIyla	yasa sI yla, yas asI yla
yatIyordun	yat Iyor du n
yaverini	yaver in i, yaver i ni
yayIndandIr	yay In dan dIr, yayIn dan dIr, yay I ndan dIr
yaygInlaStIGIna	yaygIn laS tIG In a, yaygIn laS tIG I na
yazIldIlar	yaz Il dI lar
yazarlarca	yazar lar ca
yeGlemiStik	yeG le miS ti k
yeksan	yeksan
yemleyin	yem le yin
yenilgilerde	yenil gi ler de
yerkUreye	yerkUre ye
yerlinin	yer lin in, yer li nin
yetiSsin	yet iS sin, ye t iS sin, yetiS sin
yetinmeyeceksiniz	yet in me yecek siniz, ye t in me yecek siniz
yinelemiS	yine le miS, yinele miS
yiyecekten	yiyecek ten, yi yecek ten
yokolmalarI	yokol ma larI, yokol ma lar I
yoldaSlarla	yoldaS lar la
yorganlarIn	yorgan lar In
yorumlayInIz	yor um la yInIz, yorum la yInIz
yumruklanmasI	yumruk lan ma sI
yurtseverliGinde	yurtsever liG i nde, yurtsever liG in de
zIpkInlar	zIpkIn lar
zalimane	zalimane
zarda	zard a, zar da
zehirlenmeden	zehir len me den, zehir len meden
zerrin	zerrin
zincirimiz	zincir imiz, zincir im iz
zorlamayanlarIn	zor la ma yan lar In
