aateliskalenterista	aatelis kalenter is ta, aatelis kalenteri sta
afrikka	afrikka
aidasta	aida sta, aidas ta
aikasuhteet	aika suhtee t
ainutlaatuisena	ainut laatuise na
ajankohtaisimpana	aja n kohtais impa na
ajoitustulokset	ajoit us tulokse t
aktiaan	akti a an
alapuoliselta	ala puolise lta
alhaisia	alhais i a
alkoholiliikkeet	alkoholi liikkee t
alkuraidoilta	alku raido i lta
aloitusruudussa	aloit us ruudu ssa
alueterminaalia	alue termi naali a, alue terminaali a
amerikkalaislihan	amerikkalais liha n
ammattilaisurheiluna	ammattilais urheil u na
ampumapaikka	ampu ma paikka
ankkuriketju	ankkuri ketju
antautumisilmoitustani	anta utu mis ilmoit us ta ni
apteekkareilta	apteekkare i lta
arestiin	aresti in
armahdusanomus	armahd us anomus
arviointiselvitys	arvioi nti selvi t ys
arvostamalla	arvosta ma lla
asemakaavamääräyksin	ase makaa va määrä yks i n, asema kaava määrä yks i n
asevelvollisuusikäisillä	ase velvollis uus ikäis i llä
asiantuntijalausuntojenkin	asia n tunti ja lausu nto j en kin, asia n tunti ja lausunto j en kin, asia n tunti ja lausunto jenki n
astujan	astu ja n
asuntokauppaa	asunto kauppa a
australialaisjohtoinen	australialais johtoinen
autonmuotoista	auto n muotois ta
avaintodistajien	avain todista j i en
avioeroasioita	avio ero asio i ta
avustushankkeisiin	avust us hankke i siin
balsamia	balsami a
bensatankkiin	bensa tankki in
birgittalaissisarta	birgittalais sisar ta
bravuuritekniikalla	bravuuri tekniika lla
budjettikautena	budjetti kaute na
caesarille	caesari lle
cristinan	cristina n
demokraatteina	demokraatte i na
differentiaalista	differentiaal is ta, differentiaali sta
dollarikaukaloista	dollari kaukalo i sta
eduskuviin	edus kuv i in
ehdokkuuttaan	ehdokk uut ta an
ekbergillä	ekbergi llä
elettyihin	ele tty i hin
elinviikkoinaan	elin viikko i na an
elpymisessä	elpy mise ssä
eläkelautakunnassa	eläke lauta kunna ssa
elämäntavastaan	elä mä n tava sta an, elämä n tava sta an
emuakin	emu a kin
ennennäkemättömässä	ennen näkemättömä ssä, ennen näkemättömä ssä
ensimmäinen	ensimmäinen
epäkiinteitä	epäkiinte i tä
epätyypillistä	epä tyypi llis tä
eritasoliittymäksi	eri taso liittymä ksi
erkkilään	erkkilä än
esiinnymme	esiinny mme
esipuheena	esipuhee na
espanjan	espanja n
eteläitalialaisesta	etelä italia laise sta
etukäteistarkastelu	etu käteis tarkast el u
festivaaleillakin	festivaale i lla kin
finanssiministeriö	finanssi ministeriö
fraasiinsa	fraasi i nsa
gallupkannatuksella	gallup kanna t ukse lla
gyroskooppihyrriä	gyroskooppi hyrr i ä
haavereilta	haavere i lta
hajoamistie	hajoa mis tie
hakuorganisaation	haku organisaatio n
hallitsemassa	hallitse ma ssa
halusimmekin	halus i mme kin
hankeohjaus	hanke ohja us
harhaanjohdettu	harhaanjohde ttu
harjoitustyönnöistään	harjoit us työnnö i stä än
harrasteurheiluun	harraste urheil u un
haukotella	hauko t el la
havupuille	havu pu i lle
heiluisi	heilu isi
helikopterilla	helikopteri lla
helskyttelee	helsky tt ele e
henkilölähiliikenteessä	henkilö lähiliikentee ssä
herjojanne	herjo j a nne
herännäisyys	herännäisyys
hiekkalaatikolla	hiekka laatiko lla
hiihtolenkki	hiihto lenkki
hiljaiselon	hiljais elo n
hintapudotusta	hinta pudo tu sta, hinta pudot us ta
hissikuilussa	hissi kuilu ssa
hoidattamisen	hoidatta mise n
holhoojalla	holhooja lla
hopeapikareita	hopea pikare i ta
hovioikeudelta	hovi oike ude lta
huippumaileri	huippu maileri
hulluin	hullu in, hullu i n
huolittelemaan	huoli tt ele ma an
huoneteatterissa	huone teatteri ssa
huuhaasoppaa	huuhaa soppa a
huutokaupassakin	huuto kaupa ssa kin
hymykuoppaisen	hymy kuoppaise n
hyvityssakkoa	hyvit ys sakko a
hyökkäyskohteita	hyökkä ys kohte i ta
häkämiehestä	häkä miehe stä
härmäläiseltä	härmä läise ltä
häärivää	hääri vä ä
ideoijiakaan	ideoi j i a kaan
ihmishahmoiselta	ihmis hahmoise lta
ikääntyessäänkin	ikäänty e ssä än kin
ilmanlaatumittauksia	ilma n laatu mitta uks i a, ilman laatu mitta uks i a
ilmiselvät	ilmiselvä t
iltapäiväisessä	ilta päiväise ssä
inariin	inari in
inkerinsuomalaisesta	inkeri n suomalaise sta
iranilaiselle	irani laise lle
iskemättömän	iske mättömä n
istuinosassa	istuin osa ssa
itiöt	itiö t
itsetuntopyrkimykset	itse tunto pyrkimykse t
jaetun	jae tu n
jalkapalloerotuomareilla	jalka pallo ero tuomare i lla
janakkalaa	janakkala a
jatkokäsittely	jatko käsittel y
jenkkipassari	jenkki passari
johtoaiheita	johto aihe i ta
joogaavat	joogaa va t, joogaa vat
joulujuomaksi	joulu juoma ksi
joutsenet	joutsene t
juhlavuutensa	juhlav uute nsa
julkituomaan	julkituo ma an
juodakin	juo da kin
juotettiin	juote tt i in
jyhkeitä	jyhke i tä
jälkikäsittelylinjan	jälki käsittel y linja n
jäppistä	jäppis tä
järkiisi	järk i i si
jäsenyysäänestystaistoa	jäsenyys äänest ys taisto a
jättämäksi	jättä mä ksi
jääkäriprikaatissa	jääkäri prikaati ssa
kaakkuripari	kaakkuri pari
kaasutuslaitos	kaasut us laitos
kahdeksaankymmeneen	kahdeksa an kymmene en
kaikenrotuisia	kaike n rotuis i a
kaivosyrityksen	kaivos yrit ykse n
kaksiosaista	kaksi osais ta
kalasota	kala sota
kalkkunaan	kalkkuna an
kamariatmosfääri	kamari atmosfääri
kananaskelkuvio	kana n askel kuvio
kansalaispalkkaansa	kansalais palkka a nsa
kansanlaulunomaista	kansa n laulu n omais ta
kantaaottavaa	kanta a ottava a
kapinallisjohtajat	kapinallis johta ja t
karilleajo	kari lle ajo
karsimaton	karsi mato n, karsi maton
karviselle	karvise lle
kasvattamiaan	kasva tta m i a an
kasvullisesta	kasvu llise sta
katkottuna	katko ttu na
kauimmaisilta	kauimmais i lta, kauimmais ilta
kaupannut	kaupan nut
kaupunginorkesterilta	kaupungi n orkesteri lta
kauttakulkuvienti	kaut ta kulku vie nti, kautta kulku vie nti
kehityshenkilöstö	kehit ys henkilöstö
kehäkolmosesta	kehä kolmose sta
keitoksen	keitokse n
kelloseppäliitolta	kello seppä liito lta
kenttäalue	kenttä alue
kerrospukeutumista	kerros puke utu mis ta
keräyslistoja	kerä ys listo j a
keskinkertaisissa	keskin kertais i ssa
keskuskoulussa	keskus koulu ssa
kestoonsa	kesto o nsa
kesärata	kesä rata
kiekonheittäjät	kieko n heittä jä t
kiemurtelivat	kiemurt el i vat
kiihdytinaika	kiihdytin aika
kiinnityskoukun	kiinnit ys kouku n
kiirinee	kiiri ne e
kilpailijamaihin	kilpaili ja ma i hin
kilpalattialla	kilpa lattia lla
kipristyi	kiprist y i
kirjallisuuslähteiden	kirja llis uus lähte i den
kirjoitta	kirjo i tta
kirkonkirjoihin	kirko n kirjo i hin
kisatyttöehdokkaiksi	kisa tyttö ehdokka i ksi
kivakin	kiva kin
klassikkosovituksen	klassikko sovi t ukse n
koelähetyksen	koe lähet ykse n
kohosihan	koho si han, kohos i han
koirapoika	koira poika
kokeneensa	koke nee nsa
kokonaistyöttömyyttä	kokonais työ ttöm yyt tä
kolhot	kolho t
kolmoiskierreketjuna	kolmois kierre ketju na
kommervenkein	kommervenke i n
konemestarina	kone mestari na
konserttikaudeksi	konsertti kaude ksi
konttorimäärän	konttori määrä n
korostanee	korosta ne e
korvaamalla	korvaa ma lla
koslasi	kosla si
kotikylässäni	koti kylä ssä ni
kotiteatterin	koti teatteri n
koululaiskuljettajien	koululais kuljetta j i en
koulutuspolitiikan	koulut us politiika n
kravattikaulukset	kravatti kaulukse t
krokotiilinlihaa	krokotiili n liha a
kuivakäymälässä	kuiva käymälä ssä
kuljetettavista	kuljete tta v i sta
kulmalippu	kulma lippu
kulttuurihistorialle	kulttuuri historia lle
kulumia	kulu m i a
kummastusta	kummastus ta
kunnallisvirkamiesliitolla	kunnallis virka mies liito lla
kuntaliitto	kunta liitto
kuolemanuhaksi	kuole ma n uha ksi, kuole ma nuha ksi, kuolema n uha ksi, kuolema nuha ksi
kuorruttamista	kuorrutta m i sta, kuorrutta mis ta
kurkkulaulua	kurkku laulu a
kustantajatukea	kustanta ja tuke a
kuulavalinnasta	kuu lava linna sta, kuula vali nna sta, kuula valin nasta
kuuntelijaselvityksen	kuunteli ja selvi t ykse n
kuvalehdellä	kuva lehde llä
kuvotti	kuvott i
kylvettävä	kylve ttä vä, kylvettä vä
kynäniekka	kynä niekka
kyydittävät	kyydi ttä vä t, kyydittä vä t, kyydittä vät
kärhämöintejä	kärhämöi nte j ä
käsiensä	käs i e nsä
käsivaivojensa	käsi vaivo j e nsa
käynnistämä	käynnistä mä
käyttövarmuutta	käyttö varm uut ta
kölniläisen	kölni läise n
laajentava	laaje nta va
ladata	lada ta, ladat a
laihduttavaan	laihdu tta va an
lainrikkomuksia	la i n rikkomuks i a, lai n rikkomuks i a
laivallinen	laiva llinen, laivallinen
lakipykälänsä	laki pykälä nsä
langanohueksi	langa n ohue ksi
lapsijuttu	lapsi juttu
lasiworkshop	lasi workshop
lastenaltaita	las t en alta i ta
latu	latu
laululle	laulu lle
laveamminkin	lavea mm i n kin
lehtipolemiikkia	lehti polemiikki a
leikkisyydeksi	leikk is yyde ksi, leikkis yyde ksi
lelujätit	lelu jäti t
lentokenttää	lento kenttä ä
leppeän	leppeä n
levottomuusaallon	levo ttom uus aallo n
liesikuvun	liesi kuvu n
liigahopeaa	liiga hopea a
liikennemuodoilla	liikenne muodo i lla
liikkeellämme	liikkee llä mme
liisteriin	liisteri in
likapyykkinsä	lika pyykki nsä
linnankylässä	linna n kylä ssä
lipsuivat	lipsu i vat
lisäleikkausohjelman	lisä leikka us ohjelma n
lisääntymiskykyisiä	lisäänty mis kykyis i ä
lohipyttipannulla	lohi pytti pannu lla
lomailijoiden	lomaili jo i den
loppuhinnaksi	loppu hinna ksi
lossilaiturilta	lossi laituri lta
luhtakanan	luhta kana n
luksusyhtiö	luksus yhtiö
lunastusmallilla	lunast us malli lla
luonnikas	luonnikas
luonteeton	luontee ton
luottamuksessa	luottamukse ssa
lupamääräyksiin	lupa määrä yks i in
lyhtypylvään	lyhty pylvää n
lähden	lähde n
lähikenttävartioon	lähikenttä vartio on
lähtöradan	lähtö rada n
lännenelokuvissa	länne n elo kuv i ssa
läsnäolevan	läsnä oleva n
lääkäripalveluista	lääkäri palvel u i sta
maahanmuuttojärjestelmän	maa han muutto järjestelmä n
maajoukkuekokemus	maa joukkue kokemus
maalarimestariksi	maalari mestari ksi
maanantaisesta	maanantaise sta
maaottelutason	maa ottel u taso n
maatalouslinja	maa talous linja
mahalaskuksi	maha lasku ksi
mainoslauseella	mainos lausee lla
majailevan	majaile va n
maksimisakko	maksimi sakko
mallialaa	malli ala a
mannerkoski	manner koski
marketeiksi	markete i ksi
markula	markula
matkailuväkeen	matka il u väke en
matkustajalautat	matkusta ja lauta t
mediamylläkkään	media mylläkkä än
mellunkylän	mellunkylä n
menneelle	men nee lle
merimiestaidollisia	meri mies taido llis i a
merkkikäsitykseen	merkki käsitykse en
metallieriä	metalli er i ä
metsäkanalintukantojen	metsä kana lintu kanto j en
metsästämisestä	metsästä mise stä
mielenilmaukset	miele n ilmaukse t
mielivän	mieli vä n
miettiväni	mietti vä ni
miljoonasakkoihin	miljoona sakko i hin
minkäänlaiseen	mi n kään laise en
mittauskertoihin	mitta us kerto i hin
moittivasti	moitti va sti
monisivuinen	moni sivuinen
moottoriteholtaan	moottori teho lta an
muistosäätiö	muisto säätiö
munkkiniemeläisten	munkkinieme läis t en
muovaten	muovat e n
murrettiin	murre tt i in
musiikkijuhlienne	musiikki juhl i e nne
mustalammen	musta lamme n
muurahaiskylvyssä	muurahais kylvy ssä
mykästi	mykä sti
myyntikelpoisia	myy nti kelpois i a
myöntämisvaltuudet	myöntä mis valtuude t
mätinäytteistä	mäti näytte i stä
mökävisa	mökä visa
nahkatekniikan	nahka tekniika n
naispresidenttiä	nais presidentti ä
napitettuaan	napite ttu a an
nelipelimestaruutta	neli peli mestaruut ta
nettilehdet	netti lehde t
nieleksi	nieleksi
nimettäköön	nime ttä kö ön
niskasella	niskase lla
nokkimisjärjestystä	nokki mis järjest ys tä
normaaliluokkien	normaali luokk i en
noudattelua	noudatt el u a
nukutusneulan	nuku t us neula n
nuorisovaihdossa	nuoriso vaihdo ssa
nykyaikaistuvat	nyky aika istu va t, nyky aikais tuva t, nyky aikaistu va t, nykyaikaist u va t, nykyaikaist u vat
nyrkiniskusta	nyrki n isku sta
näkökohtapsykoanalyysia	näkö kohta psyko analyysi a
näyttelijöihinsä	näytt eli jö i hi nsä, näytteli jö i hi nsä
observoinnissakin	observoi nni ssa kin
ohjasta	ohja sta, ohjas ta, ohjasta
ohjusjärjestelmissä	ohjus järjestelm i ssä
oikeuskomissaarin	oike us komissaari n
oksennusryöpyn	oksenn us ryöpy n
oltermannina	oltermanni na
omaamasta	omaa ma sta
ominaisluonnettaan	ominais luonnet ta an
onnahteli	onnaht el i
opastetuissa	opaste tu i ssa
opinahjoonsa	opi n ahjo o nsa
opistoupseerioppilas	opisto upseeri oppilas
optioina	optio i na
orvokeissa	orvoke i ssa
osallisuuskuvioita	osa llis uus kuvio i ta
ostajaorganisaation	osta ja organisaatio n
otattava	otatta va
outokummussa	outo kummu ssa, outokummu ssa
pahentamana	pahe nta ma na
paikattavaksi	paika tta va ksi
painonkontrollilääkkeitä	paino n kontrolli lääkke i tä
pakastelämpötilassa	pakaste lämpö tila ssa
pakkovalintaan	pakko vali nta an, pakko valin ta an
palautuminenkaan	palaut u minen kaan
palkintojenjakotilaisuuteen	palki nto j en jako tilais uute en, palki nto j en jako tilaisuute en, palkinto j en jako tilais uute en, palkinto j en jako tilaisuute en
palkollisiin	palkollis i in
paluuajankohdastaan	paluu aja n kohda sta an
palveluyksiköille	palvel u yksikö i lle
pankkitileille	pankki tile i lle
paperinipulla	paperi nipu lla
parantuneensa	parantu nee nsa
parlamenttivuosista	parlamentti vuos i sta
pastori	pastori
pehmentänee	pehme ntä ne e
pelastamisekseen	pelasta mise kse en
pelinkululla	peli n kulu lla
peltijunien	pelti jun i en
pergamentinpaloista	pergamenti n palo i sta
perillekin	per i lle kin, peri lle kin
persoonallisinta	persoona llis in ta
peruskurssista	perus kurssi sta
perustamperelaisen	perus tampere laise n
perämaa	perä maa
pesäpalloperhe	pesä pallo perhe
pidettäneen	pide ttä ne en
pienoisteatteri	pienois teatteri
piikittömät	piiki ttömä t
piirteestä	piirtee stä
pikkubussikyyti	pikku bussi kyyti
pikkuyrityksiä	pikku yrit yks i ä
pinkoa	pinko a
pirttijärvellä	pirtti järve llä
pitkonsa	pitko nsa
pizzankin	pizza n kin
poikkeilu	poikke il u
polarisaatiomikroskopia	polarisaatio mikroskopia
polskinut	polski nut
porkkanapenkkiin	porkka na penkki in, porkkana penkki in
poskeensa	poske e nsa
potilaspaikkamäärien	potilas paikka määr i en
pressujen	pressu j en
pronssitilaansa	pronssi tila a nsa
psykolingvistisesti	psyko lingvist ise sti
puheenjohtajaehdokkaasta	puhee n johta ja ehdokkaa sta
puhepäällä	puhe pää llä
pujottelucup	pujott el u cup
pulverit	pulveri t
puolalaisesta	puola laise sta
puolueellisilla	puoluee llis i lla
puolustusministeriölähteet	puolust us ministeriö lähtee t
purkautuneensa	purka utu nee nsa
putoamissuojausta	putoa mis suoja us ta
puupaalujen	puu paalu j en
puuvillalakanoiden	puu villa lakano i den
pystytte	pysty tte
pyyntitoiminnalla	pyynti toimi nna lla
päihdepäivä	päihde päivä
päiväntasaajassa	päivä n tasaa ja ssa
päähineestä	päähinee stä
pääministereihin	pää ministere i hin
pääsihteeriin	pää sihteeri in
päätoimituksen	pää toimi t ukse n, päätoimit ukse n
päävaaliavustaja	pää vaali avusta ja
pöydällepanopäätökseen	pöydä lle pano päätö kse en, pöydä lle pano päätökse en
raatelevia	raatele v i a
rahalaitossektorin	raha laitos sektori n
rahoitusasioissa	rahoit us asio i ssa
raittia	raitti a
rajoittaakseen	rajoitta a kse en
rakennuslupamaksulla	rakenn us lupa maksu lla
rakkaudentoiveilleen	rakka ude n toive i lle en
rannikkokaistan	rannikko kaista n
rantojensuojelusäätiölle	ranto j en suojel u säätiö lle
rastivälillä	rasti väli llä
ratkottavia	ratko tta v i a, ratko tta v i a
rauhantutkijat	rauha n tutki ja t
ravinnekuorma	ravinne kuorma
reaktiolla	reaktio lla
reittijärjestelyjä	reitti järjest el y j ä
rengastamiseen	rengasta mise en
resurssipykälää	resurssi pykälä ä
riemutohtoreita	riemu tohtore i ta
riitoihin	riito i hin
rikostentorjuntahankkeeseen	rikos t en torjunta hankkee seen
rippikoululeiriltä	rippi koulu leiri ltä
ristiriitoihin	risti riito i hin
rohkaisemana	rohkaise ma na
romukalustoilla	romu kalusto i lla
rotukissayhdistyksen	rotu kissa yhdist ykse n
rumpalit	rumpali t
ruoskivat	ruoski va t, ruoski vat
rutiinikonttorityötä	rutiini konttori työ tä
rytistävä	rytis tä vä
räkäiseksi	räkäise ksi
saalisrahoilla	saalis raho i lla
saastepilvestä	saaste pilve stä
sahaprosessinhoitajan	saha prosessi n hoita ja n
sairauspäivältä	saira us päivä ltä
salakieron	salakiero n
salopelto	salo pelto
samppanjaetiketin	samppanja etiketi n
sanktiopykäliä	sanktio pykäl i ä
sarjamestaruutta	sarja mestaruut ta
satelliittiseurannalla	satelliitti seuranna lla
savikeraamisiksi	savi keraamis i ksi
seilaamaan	seilaa ma an
sekkeinä	sekke i nä
selitä	seli tä, selit ä, selitä
selvityksillä	selvi t yks i llä
separatistisissien	separatisti siss i en
seurahuone	seura huone
shahilla	shahi lla
sieniseos	sieni seos
siirtokäytäntöjä	siirto käytäntö j ä
siivutetaan	siivute ta an
sikiämisen	sikiä mise n
silmäänpistävä	silmä än pistävä
sinivalkoiset	sini valkoise t
sissihirmut	sissi hirmu t
sisäpituudeltaan	sisä pituude lta an
siviilihallintoon	siviili hallinto on
soittotunneista	soitto tunne i sta
somalialaissyntyinen	somali alais syntyinen, somalialais syntyinen
sopimusosapuolille	sopimus osa puol i lle
sorttiseen	sorttise en
sotainvalidihuoltoa	sota i n validi huolto a, sota invalidi huolto a
sotilaskolonna	sotilas kolonna
sovellutustason	sovell ut us taso n
spurtti	spurtti
stressivasteet	stressi vastee t
suihkumoottoreille	suihku moottore i lle
sukulaispiiriä	sukulais piiri ä
sulkeutuva	sulke utu va
suojatullikysymyksissä	suo ja tulli kysymyks i ssä, suoja tulli kysymyks i ssä
suomalaiselta	suomalaise lta
suomalaisvalmistelijaksi	suomalais valmist eli ja ksi
suorastaa	suo rasta a
suotuisammiksi	suotuisa mm i ksi
surmattuna	surma ttu na
suunnittelumerkin	suunnittel u merki n
suurkilpailujen	suur kilpail u j en
suusoutujen	suu soutu j en
sydänääniään	sydän ään i ä än
synteettisestä	synteettise stä
sytytettiinkö	syty te tt i in kö
syytteillä	syytte i llä
säesti	säest i
sähkötukkukaupassa	sähkö tukku kaupa ssa
särisevä	särise vä
säädösehdotukset	säädös ehdot ukse t
säästöpäätökset	säästö päätökse t
tahdotko	tahdo t ko
taidokkaine	taidokka ine
taitamisen	taita mise n
tajulla	taju lla
takavuosikymmenten	taka vuosi kymmen t en
talletettavaksi	tallete tta va ksi
talouskasvulle	talous kasvu lle
talviajajia	talvi aja j i a
tamperelaistytön	tamperelais tytö n
tanssittaneet	tanssi tta nee t
tappiollisesta	tappio llise sta
tarkastelulla	tarkast el u lla
tarpeemme	tarpee mme
tasapaksusti	tasa paksu sti
tauluja	taulu j a
tavoitehinta	tavoite hinta
teemaiskuun	teema isku un
tehosteta	tehoste ta
tekniikoista	tekniiko i sta
tekstimerkinnän	teksti merki nnä n
televisioselostukset	tele visio selost ukse t, televisio selost ukse t
tenolla	teno lla
terapeuttinsa	terapeutti nsa
terveydenhuoltoalat	terve yde n huolto ala t
teräsverkolla	teräs verko lla
tiedelukioon	tiede lukio on
tiedusteluvirkailija	tiedust el u virkailija
tietojärjestelmiin	tieto järjestelm i in
tietotulva	tieto tulva
tiivistyksestä	tiivist ykse stä
tilatasolla	tila taso lla
tipahtaneille	tipahta ne i lle
todisteluiksi	todist el u i ksi, todiste lu i ksi
toiminkin	toim i n kin, toimi n kin
toimitsijakoulutuksen	toimitsija koulut ukse n
toiverunoja	toive runo j a
torakkamyrkylle	torakka myrky lle
tossavaisten	tossavais t en
traditionalismi	traditionalismi
tuikkivaksi	tuikki va ksi
tukiseiniin	tuki sein i in
tulipalokiire	tuli palo kiire
tulokasvu	tulo kasvu
tulppaaneillaan	tulppaane i lla an
tunnistavansa	tunnista va nsa
tunturivihviläesiintymän	tunturi vihvilä esiintymä n
tuotemerkinnät	tuote merki nnä t
tupakoivan	tupakoi va n
turkittomalla	turki ttoma lla
turvallisuusneuvostoon	turva llis uus neuvosto on
tuskallisiin	tuska llis i in
tutkimusorganisaatiota	tutkimus organisaatio ta
tuulahdus	tuulahd us
tyrmistyneeltä	tyrmisty nee ltä
tyyppikilpeä	tyyppi kilpe ä
työkykynäkö	työ kyky nä kö, työ kyky näkö
työmarkkinatutkimuksesta	työ markkina tutkimukse sta
työpalkka	työ palkka
työtiloiksi	työ tilo i ksi
tädille	tädi lle
tärisyttävät	täris yttä vä t, täris yttä vät
täytemaalaskun	täyte maa lasku n
uhanalaisia	uha n alais i a
uintipoukamassa	uinti poukama ssa
ulkomaalaisennakkoluuloja	ulko maalais ennakko luulo j a
ullakkotiloista	ullakko tilo i sta
unicef	unicef
urakierron	ura kierro n
urheilurintamalla	urheil u rintama lla
uskonpuhdistusta	usko n puhdist us ta
uudistamistyöhön	uudista mis työ hön
uuskolonialismia	uus kolonialismi a
vaahtoillen	vaahto il le n
vaalitappiota	vaali tappio ta
vaatimuksistaan	vaatimuks i sta an
vahvuutemme	vahv uute mme
vaikenemiseen	vaikene mise en
vaivattomana	vaiva ttoma na
vakoilusotkujen	vako il u sotku j en
valepuku	vale puku
valituskirjelmien	valit us kirjelm i en
valloitettuja	valloite ttu j a
valmisteveroilla	valmiste vero i lla
valotornin	valo torni n
valtiomiesaikana	valtio mies aika na
valuutalla	valuuta lla
vandalisoitu	vandalisoi tu
vankilatyötä	vankila työ tä
vapaustaistelijoiksi	vapa us taisteli jo i ksi
varareittien	vara reitt i en
varisseita	varis se i ta, varis seita
varsinaisten	varsinais t en
vasemmistosiipeä	vasemmisto siipe ä
vastaostot	vasta osto t
vastuuvalmentajakseen	vastuu valmenta ja kse en
vedenpuhdistamossa	vede n puhdistamo ssa
velipuolta	veli puol ta
venepäällikköä	vene päällikkö ä
verenpainemittaria	vere n paine mittari a
verkkotiedon	verkko tiedo n
veropolitiikalla	vero politiika lla
vertasen	vertase n
vesistöhaitoista	vesistö haito i sta
vetureista	veture i sta
vienninedistämismatkan	vie nni n edistä mis matka n
vierastyöläiset	vieras työläise t
viettäviltä	viettä v i ltä
vihreämmäksi	vihreä mmä ksi
viilari	viilari
viipyili	viipyil i
viiveillä	viive i llä
vilkuilet	vilkuile t
viranhakuilmoituksessa	vira n haku ilmoit ukse ssa
virkamieskunnan	virka mies kunna n
virstanpylvään	virsta n pylvää n
vitalistinen	vitalistinen
voimamieskilpailuissa	voi ma mies kilpail u i ssa, voima mies kilpail u i ssa
voittaneeni	voitta nee ni
vuokraamiinsa	vuokraa m i i nsa
vuoropysäköinti	vuoro pysäköi nti
vyöry	vyöry
vähittäishintojen	vähittäis hinto j en
väkirikkaimmalle	väki rikka imma lle
välipäätöksellään	väli päätökse llä än
värileikit	väri leiki t
väärinkäytösepäilysten	väär in käytös epäilys t en, väär i n käytös epäilys t en
ydinenergiainstituutista	ydin energia instituuti sta
yhdessäoloanne	yhde ssä olo a nne, yhde ssä olo anne
yhteiskiinnitys	yhteis kiinnit ys
yhteistyökoreografia	yhteis työ koreografi a, yhteis työ koreografia
yhtiömuotoja	yhtiö muoto j a
ykkösveskari	ykkös veskari
yksityisajatteluaan	yksityis ajattel u a an
yleiskorotukseksi	yleis korot ukse ksi
yleisötulojen	yleisö tulo j en
ylimitoiteta	ylimitoite ta
ylisuurilla	ylisuur i lla
yllätysuutisia	yllä t ys uutis i a, yllät ys uutis i a
ympäristöaktivisteista	ympäristö aktiviste i sta
ympäristötukijärjestelmä	ympäristö tuki järjestelmä
yrityskäyttäjillä	yrit ys käyttä j i llä
yökerhoyleisölle	yö kerho yleisö lle
äitiäni	äiti ä ni
äänenlaatua	ääne n laatu a
ääniuutisten	ääni uutis t en
öljyntorjunnan	öljy n torjunna n
